-1 -1 -1 8 -1 -1 -1 8 -1 -1
5 -1 -1 -1 -1 -1 -1 -1 -1 -1
-1 -1 -1 -1 -1 -1 -1 11 -1 -1
-1 -1 -1 -1 -1 -1 -1 -1 -1 -1
4 -1 -1 -1 -1 -1 -1 -1 -1 -1
-1 -1 -1 -1 -1 -1 -1 -1 -1 -1
4 -1 -1 -1 9 6 -1 -1 -1 -1
-1 -1 -1 -1 -1 -1 -1 -1 -1 -1
4 -1 -1 -1 -1 -1 -1 -1 10 -1
-1 -1 -1 -1 -1 -1 -1 -1 -1 -1